4 13 31
###############################
#p  b  b*1* *  b 2 *  f * *   #
#*# #b#*# # #*#*# # # #*#*#*# #
#f *f x1  s**  *  3*  s 2 * * #
# # # # # #*# #s#*#*# # # # #*#
#f 1 s* x  x **  b  *   1  3  #
# # # # # # # #s# #*# #*# # # #
#*  f   *  s  *   *  * 3  x   #
# # # #s#*# # #s#*#*# # # # # #
#* *  b*  *  3    *  * 2      #
# #*# # # # # # #*# # # # # # #
#    *      *   *  *          #
###############################