3 17 19
###################
#p f b*s *  1   * #
# # # # # # # # # #
#*f b ** * x  b * #
# #b#*# # #*# # # #
# *b2 s**  1 b f *#
# # #*#*# # # # #*#
# 1f *f *  * *  s #
# # # # # #*# # # #
#  x * 2 *fb  b   #
#*# # # # #*# # # #
#*  s* *** 2  *   #
#s# # #*# # # # #*#
#s  **3* * *  b   #
# # # #*# # # # # #
# * 3* * **  1    #
###################