6 13 31
###############################
#p f s b*1* *  b 2 *  f * *   #
# # # #*# # #*#*# # # #*#*#*# #
#* bfs 1  s**  *  3 4 s 2 * * #
# # # # # #*# #s#*#*# # # # #*#
#f 1 s * f x **  b  *   1  3  #
# # # # # # # #s# #*# #*# # # #
#* fff 4 f s  *  *   * 3      #
# #f# #s#*# # #s#*#*# # # # # #
#* b bb*  *  3    *    2   *  #
# #*# # # # # # #*# # # # # # #
#  x ss 4   *   *  *  1       #
###############################