2 17 27
###########################
#p *        1 * *  2 * *  #
# # # # # # # # # # # # # #
#**   **   x  * *   **    #
# # #*# # #*#*# # # # # # #
# *    **  1   f * *  1   #
# # #*#*# # #*# #*# #*# # #
#    *     * *  s      *  #
# # # # # #*# # # #*# # # #
#  x * 2  f   b   * 1 * * #
# # # # # #*# # # #*# # # #
#   s  **  2  *    *  *   #
# # # #*# # #*# #*# #*# # #
#   *    * *  b   *   *  *#
# # # #*# # # # # # # # # #
# *    *     1     *      #
###########################
